tile_outside.png
1,5 1,5 1,5 1,5 1,5 1,5 1,5 1,5 1,5 1,5 1,5 1,5 1,5 1,5 1,5 1,5 1,5 1,5 4,4 4,3
1,5 1,5 1,5 1,5 1,5 1,5 1,5 1,5 1,5 1,5 1,5 1,5 1,5 1,5 1,5 1,5 1,5 1,5 4,4 4,3
1,5 5,4 5,4 5,4 5,4 5,4 5,4 5,4 5,4 5,4 5,4 5,4 5,4 5,4 5,4 5,4 5,4 5,4 4,4 4,3
1,5 3,1 3,1 3,1 3,1 3,1 3,1 3,1 3,1 3,1 3,1 3,1 3,1 3,1 3,1 3,1 3,1 3,1 4,4 4,3
1,5 2,3 2,3 2,3 2,3 2,3 2,3 2,3 2,3 1,2 2,3 2,3 2,3 2,3 2,3 2,3 2,3 2,3 4,4 4,3
1,5 2,3 2,3 2,3 2,3 2,3 2,3 1,4 2,3 2,3 2,3 2,3 2,3 2,3 2,3 2,3 2,3 2,3 4,4 4,3
1,5 1,4 2,3 1,4 2,3 2,5 1,4 2,3 2,3 2,3 2,3 2,5 2,3 2,3 2,3 1,4 1,4 2,3 - 4,3
1,5 1,4 2,3 2,3 1,4 2,3 2,3 1,4 2,3 2,5 2,3 2,3 2,3 2,3 1,4 1,2 2,3 2,3 - 4,3
1,5 2,3 1,4 1,2 2,3 2,3 2,3 2,3 2,3 2,3 2,3 2,3 2,3 2,3 2,3 2,3 2,3 2,3 4,4 4,3
1,5 2,3 2,3 2,3 2,3 2,3 2,3 2,3 2,3 1,2 2,3 2,3 1,2 2,3 2,3 1,2 2,3 2,3 4,4 4,3
1,5 2,3 2,3 2,3 2,3 2,3 2,3 2,3 2,3 2,3 2,3 2,3 2,3 1,4 2,3 2,3 2,3 2,3 4,4 4,3
1,5 2,3 2,3 2,3 2,3 2,3 2,3 1,2 2,3 2,3 2,3 2,3 2,3 2,3 1,2 2,3 2,3 2,3 4,4 4,3
1,5 3,4 3,4 3,4 3,4 3,4 3,4 3,4 3,4 3,4 3,4 3,4 3,4 3,4 3,4 3,4 3,4 3,4 4,4 4,3
1,5 5,1 5,1 5,1 5,1 5,1 5,1 5,1 5,1 5,1 5,1 5,1 5,1 5,1 5,1 5,1 5,1 5,1 4,4 4,3
1,5 1,5 1,5 1,5 1,5 1,5 1,5 1,5 1,5 1,5 1,5 1,5 1,5 1,5 1,5 1,5 1,5 1,5 4,4 4,3
1,5 1,5 1,5 1,5 1,5 1,5 1,5 1,5 1,5 1,5 1,5 1,5 1,5 1,5 1,5 1,5 1,5 1,5 4,4 4,3

doors
4,1 4,2

lights
0

end