tiletest2.png
4,4 4,4 4,4 4,4 4,4 4,4 4,4 4,4 4,4 4,4 4,4 4,4 4,4 4,4 4,4 4,4 4,4 4,4 4,4 4,4
4,4 4,4 4,4 4,4 4,4 4,4 4,4 4,4 2,3 3,1 3,1 3,1 3,1 3,1 3,1 3,1 3,1 3,1 2,4 4,4
4,4 4,4 4,4 4,4 4,4 4,4 4,4 4,4 3,3 1,1 1,1 1,1 1,1 1,1 1,1 1,1 1,1 1,1 3,2 4,4
4,4 4,4 4,4 4,4 4,4 4,4 4,4 4,4 3,3 1,1 1,1 1,1 1,1 1,1 1,1 1,1 1,1 1,1 3,2 4,4
4,4 4,4 4,4 4,4 4,4 4,4 4,4 4,4 3,3 1,1 1,1 1,1 1,1 1,1 1,1 1,1 1,1 1,1 3,2 4,4
2,3 3,1 3,1 3,1 3,1 3,1 3,1 3,1 3,1 1,1 1,1 1,1 1,1 1,1 1,1 1,1 1,1 1,1 3,2 4,4
3,3 - 1,1 1,1 1,1 1,1 1,1 1,1 1,1 1,1 1,1 1,1 1,1 1,1 1,1 1,1 1,1 1,1 3,2 4,4
3,3 - 1,1 1,1 1,1 1,1 1,1 1,1 1,1 1,1 1,1 1,1 1,1 1,1 1,1 1,1 1,1 1,1 3,2 4,4
3,3 1,1 1,1 1,1 1,1 1,1 1,1 1,1 1,1 1,1 1,1 1,1 1,1 1,1 1,1 1,1 1,1 1,1 3,2 4,4
3,3 1,1 1,1 1,1 1,1 1,1 1,1 1,1 1,1 1,1 1,1 1,1 1,1 1,1 1,1 1,1 1,1 1,1 3,2 4,4
2,1 3,4 3,4 3,4 3,4 3,4 3,4 3,4 3,1 1,1 1,1 1,1 1,1 1,1 1,1 1,1 1,1 1,1 3,2 4,4
4,4 4,4 4,4 4,4 4,4 4,4 4,4 4,4 3,3 1,1 1,1 1,1 1,1 1,1 1,1 1,1 1,1 1,1 3,2 4,4
4,4 4,4 4,4 4,4 4,4 4,4 4,4 4,4 3,3 1,1 1,1 1,1 1,1 1,1 1,1 1,1 1,1 1,1 3,2 4,4
4,4 4,4 4,4 4,4 4,4 4,4 4,4 4,4 3,3 1,1 1,1 1,1 1,1 1,1 1,1 1,1 1,1 1,1 3,2 4,4
4,4 4,4 4,4 4,4 4,4 4,4 4,4 4,4 2,1 3,4 3,4 3,4 3,4 3,4 3,4 3,4 3,4 3,4 2,2 4,4
4,4 4,4 4,4 4,4 4,4 4,4 4,4 4,4 4,4 4,4 4,4 4,4 4,4 4,4 4,4 4,4 4,4 4,4 4,4 4,4

doors
4,1 4,2